11111111111111111111111
10000000000000000000001
100000000000000000P0001
1000000000CEP0000000001
11111111111111111111111
