11111111111111111111111
10000000000000000000001
10000000000000000000001
10000000000EP0000000001
11111111111111111111111
