11111111111111111111111
10000000000000000000001
10000000000000000000001
1000000000CE00000000001
11111111111111111111111
