111111111111111111111111111111111111111111111111111111111111111111111
1P100000000000000111000000000000001C0000010000111000000000000000000C1
101000000000000001C10000000000000000000000001000110000000000000001111
1C1000000000000001C10000000000000000000000001110110000000000000001111
101000000000000001C10000000000000000000000001000010000000000000001111
100000000000000001C10000000000000000000000001101110000000000000001111
100000000000000001C10000000000000000000000001000010000000000000001111
100000000000000001C10000000000000000000000001111010000000000000001111
100000000000000001C10000000000000000000000001000010000000000000001111
100000000000000001C10000000000000000000000001001010000000000000001111
100000000000000001C10000000000000000000000001001010000000000000001111
100000000000000001C10000000000000000000000001001000000000000000001111
100000000000000001C10000000000000000000000001001110000000000000001111
10000000000000000000000000000000001C1000000010C10000000000000000000E1
111111111111111111111111111111111111111111111111111111111111111111111
